2, 2, 2, 2, 2, 2, 2, 2, 2, 2, 2, 2, 2, 2, 2, 2
2, 0, 0, 0, 0, 0, 0, 0, 0, 0, 6, 0, 0, 0, 0, 2
3, 0, 6, 0, 0, 6, 0, 6, 6, 0, 6, 0, 0, 0, 0, 2
2, 0, 6, 6, 6, 0, 6, 6, 0, 6, 6, 0, 6, 0, 0, 2
2, 0, 6, 6, 6, 0, 6, 0, 6, 6, 6, 0, 0, 6, 0, 2
2, 0, 0, 0, 6, 0, 0, 0, 0, 0, 6, 0, 0, 0, 4, 2
2, 0, 0, 6, 6, 6, 0, 0, 0, 6, 6, 0, 6, 0, 0, 2
2, 0, 0, 0, 0, 6, 6, 6, 6, 6, 6, 0, 0, 6, 6, 2
3, 0, 0, 6, 0, 6, 0, 6, 0, 0, 6, 0, 0, 0, 0, 2
2, 6, 0, 6, 0, 6, 6, 0, 0, 6, 6, 0, 0, 0, 0, 2
2, 2, 2, 2, 2, 2, 2, 2, 2, 2, 2, 2, 2, 2, 2, 2