2, 2, 2, 2, 2, 2, 2, 2, 2, 2, 2, 2, 2, 2, 2, 2
2, 4, 0, 0, 0, 0, 0, 0,12, 0, 6, 0, 0, 6, 0, 2
2, 0, 0, 0, 0, 0, 0, 0, 0, 0, 6, 0, 0, 6, 0, 2
2, 0, 6, 6, 6, 0, 6, 6, 6, 0, 6, 0, 6, 6, 0, 2
2, 0, 0, 6, 0, 0, 0, 0, 6, 0, 6, 0, 0, 6, 0, 2
2, 0, 0, 6, 0, 6, 0, 0, 6, 0, 6, 6, 0, 0, 0, 2
2, 0, 0, 6, 0, 6, 0, 0, 0, 0, 6, 6, 6, 0, 0, 2
2, 0, 6, 6, 0, 6, 0, 6, 6, 6, 6, 0, 0, 6, 6, 2
2, 0, 0, 0, 0, 6, 0, 6, 0, 0, 6, 0, 0, 0, 0, 3
2, 0, 0, 0, 0, 0, 6, 0, 0, 6, 6, 0, 0, 0, 0, 2
2, 2, 2, 2, 2, 2, 2, 2, 2, 2, 2, 2, 2, 2, 2, 2